*E*******
*       *
*  ***  *
* * *   *
* * *** *
*   *   *
**  S * *
*       *
*********
