*********
*       *
*   *****
E   *   *
*   *****
*       *
**  S   *
*       *
*********