*********
*       *
*   *****
E   *   *
*   *****
*S      *
**      *
*       *
*********